00000000000000000000000000000000000000000000000000000000000000000000000000000000000000000000000000000000000000000000000000000000
00000000000000000000000000000000000000000000000000000000000000000000000000000000000000000000000000000000000000000000000000000000
00000000000000000000000000000000000000000000000000000000000000000000000000000000000000000000000000000000000000000000000000000000
00000000000000000000000000000000000000000000000000000000000000000000000000000000000000000000000000000000000000000000000000000000
00000000000000000000000000000000000000000000000000000000000000000000000000000000000000000000000000000000000000000000000000000000
00000000000000000000000000000000000000000000000000000000000000000000000000000000000000000000000000000000000000000000000000000000
00000000000000000000000000000000000000000000000000000000000000000000000000000000000000000000000000000000000000000000000000000000
00000000000000000000000000000000000000000000000000000000000000000000000000000000000000000000000000000000000000000000000000000000
00000000000000000000000000000000000000000000000000000000000000000000040000400000000000000000000000000000000000000000000000000000
00000000000000000000000000000000000000000000000111110000000000000000040000400000000000000000000000000000000000000000000000000000
00000000000000000004400000000000000000000000000111110000000000000000040000400000000000000000000000000000040400000000000000000000
00000000000000000004431111111111111111110000000111110000000000000000000000400000000000000000000000000000040400000000000000000000
00000000000000000004431111111111111111111111111111111111111111111111111000000000000000000000000000000000040400000000000000000000
00000000000000004000431111111111111111111111111111111111111111111111111111111200000000000000000000004000040400004000000000000000
00000000000000004000431111111111111111111111111111111111111111111111111111111200000004000000000000004000040400004000000000000000
00000000000000004000431111111111111111111111111111111111111111111111111111111200000004000000000000004000040400004000000000000000
00000000000000000000011111111111111111110000000000000000000000000000000000000000000004000000000000000000000000000000000000000000
00000000000000000000011111111111111111110000000000000000000000000000000000000000000004000000000000000000000000000000000000000000
00000000000000000000011111111111111111110000000000000000000000000000000000000000000000000000000000000000000000000000000000000000
00000000000000000000000000000000000000000000000000000000000000000000000000000000000000000000000000000000000000000000000000000000
00000000000000000000000000000000000000000000000000000000000000000000000000000000000000000000000000000000000000000000000000000000
00000000000000000000000000000000000000000000000000000000000000000000000000000000000000000000000000000000000000000000000000000000
00000000000000000000000000000000000000000000000000000000000000000000000000000000000000000000000000000000000000000000000000000000
00000000000000000000000000000000000000000000000000000000000000000000000000000000000000000000000000000000000000000000000000000000
