0000000w0000000000000000000000000000000000000000000000000000000000000000000000000000000000000000000000000000000000000000w0000000
0000000w0000000000000000000000000000000000000000000000000000000000000000000000000000000000000000000000000000000000000000w0000000
0000000w0000000000000000000000000000000000000000000000000000000000000000000000000000000000000000000000000000000000000000w0000000
0000000w0000000000000000000000000000000000000000000000000000000000000000000000000000000000000000000000000000000000000000w0000000
0000000w0000000000000000000000000000000000000000000000000000000000000000000000000000000000000000000000000000000000000000w0000000
0000000w0000000000000000000000000000000000000000000000000000000000000000000000000000000000000000000000000000000000000000w0000000
0000000w0000000000000000000000000000000000000000000000000000000000000000000000000000000000000000000000000000000000000000w0000000
0000000w0000000000000000000000000000000000062225000622500000000000000000000000000000000000000000000000000000000000000000w0000000
0000000w0000000000000000000000000000062222241117000811322250000000000eccccd000000000000000000000000000000000000000000000w0000000
0000000w0000000000000000000000000622241111111117cd0811111132222500000000000000000000000000000000000000000000000000000000w0000000
0000000w00000000000ed622222222222411111111111117000811111111111322225000000000000000000000000000000000000ecd000000000000w0000000
0000000w0000000000000819999999999999999111111117000811111111111111113222500000000000000000000000000000000000000000000000w0000000
0000000w0000000000000870000000000000000a9999999a0ecb99999999999999999911322225cd0000000000622225000000000000000000000000w0000000
6500000w00000000ecccdba00000000000000000000000000000000000000000000000b999999a0000000000008111170000ecccccccccccd0000000w0000065
8325000w00000000000000000000000000000000000000000000000000000000000000000000000000000ecccc811117000000000000000000000000w0006247
8113250w0x000000000000000000000000000000000000062222222222222500000000000000000000000000008111135000000000000000000000y0w0624117
811113222222222222225cd00000eccd00000ec62222222411111111111113222222222222222500000000000641111132222222222222222222222222411117
8111111111111111111170000000000000000008111111111111111111111111111111111111170000ff00006411111111111111111111111111111111111117
811111111111111111117ffffffffffffffffff81111111111111111111111111111111111111322222222224111111111111111111111111111111111111117
81111111111111111111322222222222222222241111111111111111111111111111111111111111111111111111111111111111111111111111111111111117
81111111111111111111111111111111111111111111111111111111111111111111111111111111111111111111111111111111111111111111111111111117
81111111111111111111111111111111111111111111111111111111111111111111111111111111111111111111111111111111111111111111111111111117
81111111111111111111111111111111111111111111111111111111111111111111111111111111111111111111111111111111111111111111111111111117
81111111111111111111111111111111111111111111111111111111111111111111111111111111111111111111111111111111111111111111111111111117
