00000000w00000000000000000000000000000000000000000000000000000000000000000000000000000000000000000000000000000000000000w00000000
00000000w00000000000000000000000000000000000000000000000000000000000000000000000000000000000000000000000000000000000000w00000000
00000000w00000000000000000000000000000000000000000000000000000000000000000000000000000000000000000000000000000000000000w00000000
00000000w00000000000000000000000000000000000000000000000000000000000000000000000000000000000000000000000000000000000000w00000000
00000000w00000000000000000000000000000000000000000000000000000000000000000000000000000000000000000000000000000000000000w00000000
22222222225000000000000000000000000000000000000000000000000000000000000000000000000000000000000000000000000000000000000w00000000
11111111113500000000000000000000000000000000000000000000000000622222225000000000000000000000000000000000000000000000000w00000000
11111111111350000000000000000000000000000000000000000000000006411111113500000000000000000000000000000000000000000000000w00000000
11111111111135000000000000000000000000000000000000000000000064111111111350000000000000000000000000000000000000006222222222222222
11111111111113500000000000000000000000000000000000000000006241111111111132500000000000000000000000000000000000064111111111111111
1111111111111135000000000000000000000000000000000000000000b999999999999999a00000000000000000000000000000000000641111111111111111
99999999999999935000000000000000000000000000000000000000000000000000000000000000000000000000000000000000000006411111111111111111
00000000w000000b3500000000000000000000000000000000000000000000000000000000000000000000000000000000000000000064111111111111111111
00000000w0000000b350000000000000062250000000000000000006222222222222222222222500000000000000000000000000000641111111111111111111
00000000w00000000b90000000000000641135000000000000000064111111111111111111111350000000000000000000000000006411111111111111111111
00000000w0x000000000000000000006411113500000000000000641111111111111111111111135000622500000000006225000064999999999999999999999
52222222222222222222222222222224111111322222222222222411111111111111111111111117000000000000000000000000000000000000000w00000000
511111111111111111111111111111111111111111111111111111111111111111111111111111170000000006225000000000000000000000000y0w00000000
51111111111111111111111111111111111111111111111111111111111111111111111111111117000000000000000000000000622222222222222222222222
51111111111111111111111111111111111111111111111111111111111111111111111111111113222222222222222222222222411111111111111111111111
51111111111111111111111111111111111111111111111111111111111111111111111111111111111111111111111111111111111111111111111111111111
51111111111111111111111111111111111111111111111111111111111111111111111111111111111111111111111111111111111111111111111111111111
51111111111111111111111111111111111111111111111111111111111111111111111111111111111111111111111111111111111111111111111111111111
51111111111111111111111111111111111111111111111111111111111111111111111111111111111111111111111111111111111111111111111111111111