00000000w00000000000000000000000000000000000000000000000000000000000000000000000000000000000000000000000000000000000000w00000000
00000000w00000000000000000000000000000000000000000000000000000000000000000000000000000000000000000000000000000000000000w00000000
00000000w00000000000000000000000000000000000000000000000000000000000000000000000000000000000000000000000000000000000000w00000000
00000000w00000000000000000000000000000000000000000000000000000000000000000000000000000000000000000000000000000000000000w00000000
00000000w00000000000000000000000000000000000000000000000000000000000000000000000000000000000000000622222222222222222222500000000
00000000w00000000000000000000000000000000000000000000000000000000000000000000000000000000000000eccb99999999999999999911700000000
00000000w00000000000000000000000000000006222222222225cccd00000000000000000000000000000000000000000000000000000000000081350000000
00000000w00000000000000000000000000000008111111111117000000000000000000000000000000000000000000000000000000000000000081170000000
00000000w0000000000000000000622222500000b99999999999a000000000622222225000000000000000000000000000622222222222222222241135000000
00000000w00000000000000000000000000000000000000000000000000000000000000000062222222225000000000000811111111111111111111113500000
00000000w00000000000000000000000000000000000000000000000000000000000000000000000000000000000062222411111111111111111111111325000
00000000w0000062222250000000000000000000622222222222500000000000000000000000000000000000000008111111111111111111111111111111a000
00000000w000000000000000000000000000000081111111111170000006222250000000000000000006222500000811111111111111111111111111199a0000
b5000000w00000000000000000000000000000008111111111117cd00000000000000000000000000000000000000b99999999999999999999999999a0000065
51250000w00000000000000622222222225000008111111111117000000000000000000622222225000000000650000000000000000000000000000w00006247
5113250xw00000000000000811111111117fffff8111111111117000000000000000000811111117000000000000000000000000000000000000000wy0624117
51111322222222222222222411111111113222224111111111113222222222222222222411111113222222222222222222222222222222222222222222411117
51111111111111111111111111111111111111111111111111111111111111111111111111111111111111111111111111111111111111111111111111111117
51111111111111111111111111111111111111111111111111111111111111111111111111111111111111111111111111111111111111111111111111111117
51111111111111111111111111111111111111111111111111111111111111111111111111111111111111111111111111111111111111111111111111111117
51111111111111111111111111111111111111111111111111111111111111111111111111111111111111111111111111111111111111111111111111111117
51111111111111111111111111111111111111111111111111111111111111111111111111111111111111111111111111111111111111111111111111111117
51111111111111111111111111111111111111111111111111111111111111111111111111111111111111111111111111111111111111111111111111111117
51111111111111111111111111111111111111111111111111111111111111111111111111111111111111111111111111111111111111111111111111111117