0000000w0000000000000000000000000000000000000000000000000000000000000000000000000000000000000000000000000000000000000000w0000000
0000000w00000000000000000000000000000000000000000000000000000000000000000000000000000000000000000000000000000000000000y0w0000000
0000000w000000000000000000000000000000000000000000000000000000000000000000000000000000000000000000062222222222222222222222222222
0000000w000000000000000000000000000000000000000000000000000000000000000000000000000000000000000000081111111111111111111111111111
0000000w0000000000000000000000000000000000000000000000000000000000000000000000000000000000000000eccb9999999999999911111111111111
0000000w000622222222222222222222250000625000000062222222222222225000000000000000000000000000000000000000000000000081111111111111
0000000w000811111199999999911111170000000000000000000000000000000000062500000000000000000000000000000000000000000081111111111111
0000000w0ec8111117000000000811111700000000000000000000000000000000000000000000000000000000000000000622222222225d0081111111111111
0000000w00081111170000000008111117cd00000062500000000000000000000000000000000622222222222222222222241111111111700081111111111111
0000000w000811111700000000081111170000000000000000000000000000000000000000000811111199999999999999999999999999a00e81111111111111
0000000w0ec81111132225000008111117000000000000000000eccccd0000000006222225000811111700000000000000000000000000000081111111111111
0000000w000811111700000000081111170000062222250000000000000000000000000000000811111700000000000000000000000062222241111111111111
0000000w000811111700000000081111170000000000000000000000000000000000000000000811111700000000000000000000000000000081111111111111
6500000w0ecb99999a00000006249999935000000000000000000000006222225000000000000b99999322222222222222222250000000000081111111111111
8325000w000000000000000000000000000000000000000000000000000000000000000000000000000000000000000000000000000000000081111111111111
8113250w0x0000000000000000000000000000000000000000000000000000000000000000000000000000000000000000000000000062222241111111111117
81111322222222222222222222222222222222222222222222222222222222222222222222222222222222222222222222222222222241111111111111111117
81111111111111111111111111111111111111111111111111111111111111111111111111111111111111111111111111111111111111111111111111111117
81111111111111111111111111111111111111111111111111111111111111111111111111111111111111111111111111111111111111111111111111111117
81111111111111111111111111111111111111111111111111111111111111111111111111111111111111111111111111111111111111111111111111111117
81111111111111111111111111111111111111111111111111111111111111111111111111111111111111111111111111111111111111111111111111111117
81111111111111111111111111111111111111111111111111111111111111111111111111111111111111111111111111111111111111111111111111111117
81111111111111111111111111111111111111111111111111111111111111111111111111111111111111111111111111111111111111111111111111111117
81111111111111111111111111111111111111111111111111111111111111111111111111111111111111111111111111111111111111111111111111111117
