00000000w00000000000000000000000000000000000000000000000000000000000000000000000000000000000000000000000000000000000000w00000000
00000000w00000000000000000000000000000000000000000000000000000000000000000000000000000000000000000000000000000000000000w00000000
00000000w00000000000000000000000000000000000000000000000000000000000000000000000000000000000000000000000000000000000622222222225
00000000w00000000000000000000000000000000000000000000000000000000000000000000000000000000000000000000000000000000006411111111111
00000000w00000000000000000000000000000000000000000000000000000000000000000000000000000000000000000000000000000000064111111111111
00000000w00000000000000000000000000000000000000000000000000000000000000000000000000000000000000000000000000000000641111111111111
00000000w00000000000000000000000000000000000000000000000000000000000000000000000000000000000000000000000000000006411111111111111
00000000w00000000000000000000000000000000000000000000000000000000000000000000000000000000000000000000000000000064111111111111111
00000000w00000000000000000000000000000000000000000000000000000000000000000000000000000000000000000000000000000641111111111111111
00000000w00000000000000000000000000000000000000000622222222250000000000000000000000000000000000000000000000006411111111111111111
00000000w00000000000000000000000000000000000000000000000000000000625000000000000000000000000000000000000000064111111111111111111
00000000w00000000000000000000000000000622500000000000000000000000000000000000000000000000000000000000000000641111111111111111111
00000000w00000000000000000000000000622411322500000000000000000000000006222222500006225000000000000000000062411111111111111111111
b5000000w00000006225000000000000062411111111325000f00000000000000000008111111700000000000622500000000eccc64999999999999999999999
13250000w00000064113500000062222241111111111113222222222222222222222224111111700000000000000000000000000000000000000000w00000000
1113500xw00000641111350000081111111111111111111111111111111111111111111111111700000eccd00000000000000000000000000000000wy0000000
11113222222222411111132222241111111111111111111111111111111111111111111111111700000000000000000622222222222222222222222222222222
511111111111111111111111111111111111111111111111111111111111111111111111111117ffff0000000000000811111111111111111111111111111116
51111111111111111111111111111111111111111111111111111111111111111111111111111322222222222222222411111111111111111111111111111116
51111111111111111111111111111111111111111111111111111111111111111111111111111111111111111111111111111111111111111111111111111116
51111111111111111111111111111111111111111111111111111111111111111111111111111111111111111111111111111111111111111111111111111116
51111111111111111111111111111111111111111111111111111111111111111111111111111111111111111111111111111111111111111111111111111116
51111111111111111111111111111111111111111111111111111111111111111111111111111111111111111111111111111111111111111111111111111116
51111111111111111111111111111111111111111111111111111111111111111111111111111111111111111111111111111111111111111111111111111116