00000000000000000000000000000000000000000000000000000000000000000000000000000000000000000000000000000000000000000000000000000000
00000000000000000000000000000000000000000000000000000000000000000000000000000000000000000000000000000000000000000000000000000000
00000000000000000000000000000000000000000000000000000000000000000000000000000000000000000000000000000000000000000000000000000000
00000000000000000000000000000000000000000000000000000000000000000000000000000000000000000000000000000000000000000000000000000000
00000000000000000000000000000000000000000000000000000000000000000000000004000400000040000040000000000000000000000000000000000000
00000000000000000000000000000000000000000000000000000000000000000000000004000400000040000040000000000000000000000000000000000000
00000000000000000000000000000000000000000000000000000000000000000000000004000400000040000040000000000000000000000000000000000000
00000000000000000000000000000000000000000000000000000000000000000000000004000400000040000040004000400000000000000000000000000000
00000000000000000000000000000000000000000000000000000000000000000000000004000400000040000040004000400000000000000000000000000000
00000000000000000000000000000000000000000000000000000000000000000000000004000400000040000040004000400000000000000000000000000000
00000000000000000000000000000000000000000031111111111111111111111111111111111112000040000040004000400040004000000000000000000000
00000000000000000000000000000000000000000031111111111111111111111111111111111112000040000040004000400040004000000000000000000000
00000000000000000000000000000000000000000031111111111111111111111111111111111112000040000040004000400040004000000000000000000000
00000000000000400040000000000000000000000001110000000000111111100000000000000111000040000040004000400040004000000000000000000000
00000000000000400040000000000000001111111111110000111111111111111111100000000111000040000040004000400040004000000000000000000000
00000000000000400040000000000000111111111111111111111111111111111111111111111111111111000040004000400040004000000000000000000000
00000000000000000000000000000001111111111111111111111111111111111111111111111111111111000000004000400040004000000000000000000000
00000000000000000000000000000000000000000000000000000000000000000000000000011111111111000000000000000000000000000000000000000000
00000000000000000000000000000000000000000000000000000000000000000000000000011111111111000000000000000000000000000000000000000000
00000000000000000000000000000000000000000000000000000000000000000000000000000000000000000000000000000000000000000000000000000000
00000000000000000000000000000000000000000000000000000000000000000000000000000000000000000000000000000000000000000000000000000000
00000000000000000000000000000000000000000000000000000000000000000000000000000000000000000000000000000000000000000000000000000000
00000000000000000000000000000000000000000000000000000000000000000000000000000000000000000000000000000000000000000000000000000000
00000000000000000000000000000000000000000000000000000000000000000000000000000000000000000000000000000000000000000000000000000000
