00000000000000000000000000000000000000000000000000000000000000000000000000000000000000000000000000000000000000000000000000000000
00000000000000000000000000000000000000000000000000000000000000000000000000000000000000000000000000000000000000000000000000000000
00000000000000000000000000000000000000000000000000000000000000000000000000000000000000000000000000000000000000000000000000000000
00000000000000000000000000000000000000000000000000000000000000000000000000000000000000000000000000000000000000000000000000000000
00000000000000000000000000000000000000000000000000000000000000000000000000000000000000000000000000000000000000000000000000000000
00000000000000000000000040000400000011111111110000000000000000000000000000000000000000000000000000000000000000000000000000000000
00000000000000400004000040000400000111111111111000000000000000000000000000000000000000000000000000044000000000000000000000000000
00000000000000400004000040000400001111111111111100000000000000000000000000000000000000000000000000044000000000000000000000000000
00000000000000400004000040000400011111111111111111200000000000000000000000000000000000000311111111244311111000000000000000000000
00000000000000400004000040000400011111111111111111200000000000000000000000000000000000000311111111244311111000000000000000000000
00000000000000400004000040000400011111111111111111200000000000000000000000000000000000000311111111244311111000000000000000000000
00000000000000400004000040000000011111111111111111111000000000000000000000000000000000000111111111244311111000000000000000000000
00000000000000400004000040000111111111111111511111511000000000000000000000000000000003111111111111244311111111120000000000000000
00000000000000400004000040003111111111111111511111511000000000000000400040000000000003111111111111244311111111120000000000000000
00000000000000400004000040003111111111111111511111511000000000000000400040000000000003111111111111244311111111120000000000000000
00000000000000000000000000003000000000000000000000000000000000000000000000000000000000000000000000000000000000000000000000000000
00000000000000000000000000000000000000000000000000000000000000000000000000000000000000000000000000000000000000000000000000000000
00000000000000000000000000000000000000000000000000000000000000000000000000000000000000000000000000000000000000000000000000000000
00000000000000000000000000000000000000000000000000000000000000000000000000000000000000000000000000000000000000000000000000000000
00000000000000000000000000000000000000000000000000000000000000000000000000000000000000000000000000000000000000000000000000000000
00000000000000000000000000000000000000000000000000000000000000000000000000000000000000000000000000000000000000000000000000000000
00000000000000000000000000000000000000000000000000000000000000000000000000000000000000000000000000000000000000000000000000000000
00000000000000000000000000000000000000000000000000000000000000000000000000000000000000000000000000000000000000000000000000000000
00000000000000000000000000000000000000000000000000000000000000000000000000000000000000000000000000000000000000000000000000000000
