0000000w0000000000000000000000000000000000000000000000000000000000000000000000000000000000000000000000000000000000000000w0000000
0000000w0000000000000000000000000000000000000000000000000000000000000000000000000000000000000000000000000000000000000000w0000000
0000000w0000000000000000000000000000000000000000000000000000000000000000000000000000000000000000000000000000000000000000w0000000
0000000w0000000000000000000000000000000000000000000000000000000000000000000000000000000000000000000000000000000000000000w0000000
0000000w0000000000000000000000000000000000000000000000000000000000000000000000000000000000000000000000000000000000000000w0000000
0000000w0000000000000000000000000000000000000000000006222500000000000000000000000000000000000000000000000000000000000000w0000000
0000000w0000000000000000000000000000000000000000000000000000000000000000000000000000000000000000000000000000000000000000w0000000
0000000w0000000000000000000000000000000000000000000000000000000000000000000000000000000000000000000000000000000000000000w0000000
0000000w000000000000000000000000000000000000062222222222222222222225ccd0000006222500000000000000000000000000000000000000w0000000
0000000w0000000000000000000000000000000000000b999999999999999999999a000000000b999a00000000000000000000000000000000000000w0000000
0000000w00000000000000000000000000000000000000000000000000000000000000000000000000000ecccccd0000000000000000000000000000w0000000
0000000w0000000000000000000000000000062225000000000000000000000000000000000000000000000000000000000000000000000000000000w0000000
0000000w0000000000000000000000000000000000000006222222222250000000000000000000000000000000000000000000000000000000000000w0000000
6500000w000000000000000000000000000000000000000811111111117000000000000000000062225ccd00000ecc62225000000000000000000000w0000065
8325000w00000000000000eccc6222225000000000000624111111111132500000000000000000000000000000000000000000000000000000000000w0006247
8113250w0x000000000000000000000000000000000008111111111111117000000000000000ff0000000000000000000000000000000000000000y0w0624117
8111132222222222222250000000000000000006222224111111111111113222222222222222250000000ecccccd000000062222222222222222222222411117
811111111111111111117000000000000000000811111111111111111111111111111111111117000000000fff00000000081111111111111111111111111117
81111111111111111111322222222222222222241111111111111111111111111111111111111322222222222222222222241111111111111111111111111117
81111111111111111111111111111111111111111111111111111111111111111111111111111111111111111111111111111111111111111111111111111117
81111111111111111111111111111111111111111111111111111111111111111111111111111111111111111111111111111111111111111111111111111117
81111111111111111111111111111111111111111111111111111111111111111111111111111111111111111111111111111111111111111111111111111117
81111111111111111111111111111111111111111111111111111111111111111111111111111111111111111111111111111111111111111111111111111117
81111111111111111111111111111111111111111111111111111111111111111111111111111111111111111111111111111111111111111111111111111117
