0000000w0000000000000000000000000000000000000000000000000000000000000000000000000000000000000000000000000000000000000000w0000000
0000000w0000000000000000000000000000000000000000000000000000000000000000000000000000000000000000000000000000000000000000w0000000
0000000w0000000000000000000000000000000000000000000000000000000000000000000000000000000000000000000000000000000000000000w0000000
0000000w0000000000000000000000000000000000000000000000000000000000000000000000000000000000000000000000000000000000000000w0000000
0000000w0000000000000000000000000000000000000000000000000000000000000000000000000000000000000000000000000000000000000000w0000000
0000000w0000000000000000000000000000000000000000000000000000000000000000000000000000000000000000000000000000000000000000w0000000
0000000w0000000000000000000000000000000000000000000000000000000000000000000000000000000000000000000000000000000000000000w0000000
0000000w0000000000000000000000000000000000000000000000000000000000000000000000000000000000000000000000000000000000000000w0000000
0000000w0000000000000000000000000000000000000000000000000000000000000000000000000000000000000000000000000000000000000000w0000000
0000000w0000000000000000000000000000000000000000000000000000000000000000000000000000000000000000000000000000000000000000w0000000
0000000w0000000000000000000000000000000000000000000000000000000000000000000000000000000000000000000000000000000000000000w0000000
0000000w00000000000000000000ecccd000000000000000000000000000000000000000000000000000000000000000000000000000000000000000w0000000
0000000w0000000000000000000000000000000000000000000000000000000000000000000000000000000000000000000000000000000000000000w0000000
6500000w0000000000ecccd0000000000000000000000000000000000000000000000000000000000000000000000000000000000000000000000000w0000065
8325000w0000000000000000000000ecccd00000000000000062222222222225000000000000000000ecd00000ecd0000000000000000000000000y0w0006247
8113250w0x0000000000f0000000000000000000f006222222411111111111132222222250000000000000000000000000000000622222222222222222224117
81111322222222222222500000000000000000062224111111111111111111111111111132222500000000000000000000062222411111111111111111111117
811111111111111111113222222222222222222411111111111111111111111111111111111117fffffffffffffffffffff81111111111111111111111111117
81111111111111111111111111111111111111111111111111111111111111111111111111111322222222222222222222241111111111111111111111111117
81111111111111111111111111111111111111111111111111111111111111111111111111111111111111111111111111111111111111111111111111111117
81111111111111111111111111111111111111111111111111111111111111111111111111111111111111111111111111111111111111111111111111111117
81111111111111111111111111111111111111111111111111111111111111111111111111111111111111111111111111111111111111111111111111111117
81111111111111111111111111111111111111111111111111111111111111111111111111111111111111111111111111111111111111111111111111111117
81111111111111111111111111111111111111111111111111111111111111111111111111111111111111111111111111111111111111111111111111111117
