0000000w0000000000000000000000000000000000000000000000000000000000000000000000000000000000000000000000000000000000000000w0000000
0000000w0000000000000000000000000000000000000000000000000000000000000000000000000000000000000000000000000000000000000000w0000000
0000000w0000000000000000000000000000000000000000000000000000000000000000000000000000000000000000000000000000000000000000w0000000
0000000w0000000000000000000000000000000000000000000000000000000000000000000000000000000000000000000000000000000000000000w0000000
0000000w0000000000000000000000000000000000000000000000000000000000000000000000000000000000000000000000000000000000000000w0000000
0000000w0000000000000000000000000000000000000000000000000000000000000000000000000000000000000000000000000000000000000000w0000000
0000000w0000000000000000000000000000000000000000000000000000000000000000000000000000000000000000000000000000000000000000w0000000
0000000w0000000000000000000000000000000000000000000000000000000000000000000000000000000000000000000000000000000000000000w0000000
0000000w0000000000000000000000000000000000000000000000000000000000000000000000000000000000000000000000000000000000000000w0000000
0000000w00000000000000000000000000000000000006222222222222222222222225ccd00000000000000000000000000000000000000000000000w0000000
0000000w0000000000000000000000000000000000eccb99999999999999999999999a00000000000eccccccd0000000000000000000000000000000w0000000
0000000w0000000000000000000000000000000000000000000000000000000000000000000000000000000000000000000000000000000000000000w0000000
0000000w0000000000000000000ecccd0000000000000000000000000000000000000000000000000000000000000000000000000000000000000000w0000000
6500000w000000000eccd000000000000000000000ecc6222222222222222222222225ccd00000000eccccccd0000000000000000000000000000000w0000065
8325000w0000000000000000fff00000fff0000000000811111111111111111111111700000000000000000000000000000000000000000000000000w0006247
8113250w0x000000000000006250000062500000000624111111111111111111111117000000000000000000000000000000000622222222225000y0w0624117
811113222222222222225000b9a00000b9a000062224111111111111111111111111132222222500000000000000622222222224111111111132222222411117
811111111111111111117f0000000000000000f811111111111111111111111111111111111117ffffffffffffff811111111111111111111111111111111117
81111111111111111111322222222222222222241111111111111111111111111111111111111322222222222222411111111111111111111111111111111117
81111111111111111111111111111111111111111111111111111111111111111111111111111111111111111111111111111111111111111111111111111117
81111111111111111111111111111111111111111111111111111111111111111111111111111111111111111111111111111111111111111111111111111117
81111111111111111111111111111111111111111111111111111111111111111111111111111111111111111111111111111111111111111111111111111117
81111111111111111111111111111111111111111111111111111111111111111111111111111111111111111111111111111111111111111111111111111117
81111111111111111111111111111111111111111111111111111111111111111111111111111111111111111111111111111111111111111111111111111117
