00000000w00000000000000000000000000000000000000000000000000000000000000000000000000000000000000000000000000000000000000w00000000
00000000w00000000000000000000000000000000000000000000000000000000000000000000000000000000000000000000000000000000000000w00000000
00000000w00000000000000000000000000000000000000000000000000000000000000000000000000000000000000000000000000000000000000w00000000
00000000w00000000000000000000000000000000000000000000000000000000000000000000000000000000000000000000000000000000000000w00000000
00000000w00000000000000000000000000000000000000000000000000000000000000000000000000000000000622222500625000000000000000w00000000
00000000w000000000000000eccccc00000625d062222250000000000000000000000000000000000000000000064111117ed813500000000000000w00000000
00000000w00000eccccd00000000000000641700b999913500000000000000000000000000000000000000000064111111700811350000000000000w00000000
00000000w00000000000000000000000064117000000081350000000000000000000000000000000000000000641111111700811135000000000000w00000000
00000000w0000000000000000000000064999accd0000b9932500000000000000000000000000000000000006499999999aedb99913500000000000w00000000
00000000w00000eccccd000000000006470000000000000000000000000000000000000000000000000000000000000000000000813250000000000w00000000
00000000w00000000000000000000064170000000000000000000000000000000000000000000000000000000000000000000000081135000000000w00000000
00000000w00000000000000000000641132222222500ecccccd6250000000622225000000000622225000062222222222cccccd00b1113500000000w00000000
22250000w00000622225000000006499999999999a000000000813500000000000000000000000000000064999999999a0000000008111350000000w00006222
11135000w00000000000000000000000000000000000ecccccd81135000000000000ecccd00000000000000000000000000000ecccb9999a0000000w00064111
1111350xw00000000000000000000000000000000000000000081117000000000000000000000000000000000000000000000000000000000000000wy0641111
11111322222222222222222222222222222222222222222222241113222222222222222222222222222222222222222222222222222222222222222222222222
51111111111111111111111111111111111111111111111111111111111111111111111111111111111111111111111111111111111111111111111111111111
51111111111111111111111111111111111111111111111111111111111111111111111111111111111111111111111111111111111111111111111111111111
51111111111111111111111111111111111111111111111111111111111111111111111111111111111111111111111111111111111111111111111111111111
51111111111111111111111111111111111111111111111111111111111111111111111111111111111111111111111111111111111111111111111111111111
51111111111111111111111111111111111111111111111111111111111111111111111111111111111111111111111111111111111111111111111111111111
51111111111111111111111111111111111111111111111111111111111111111111111111111111111111111111111111111111111111111111111111111111
51111111111111111111111111111111111111111111111111111111111111111111111111111111111111111111111111111111111111111111111111111111
51111111111111111111111111111111111111111111111111111111111111111111111111111111111111111111111111111111111111111111111111111111